##############################################################
#S                              #     #              #       #
############### #############   #  #  #  #  ########## #######
#      #   #                #      #     #           # #     #
#      #   # #       #      ######### #############  # #     #
#      # # # #       #      #                                #
#        #   ####### #                ########      ##########
#        #   #       #                                       #
#    #################      #                     ## #####   #
#    #   #                  #  #     #########    ##  #      #
#    #   # ##### ####           #       #         #  ## #    #
#                        #####   #      #         #     #    #
###### ###################   ##   #     #         #######    #
#          #  #      #        ###  #    #         #          #
## #########  #  #   #          ##  ########## ####          #
#          #     #                           # ###############
########## ############## ###################                #
#               #            #       #     ################  #
### ########      ####       #   #   #  #  #  #              #
#    #          #    #       #   #      #       ##############
# ####  ###     #    ##########################        #     #
#    #   #      #          #                           #     #
####    ####    ######     #     #   ##############    #     #
#         #     #          #     #  ##   #  #          #     #
#    ################ #######    #           #         #     #
#  #  #  #      #        #      #####################        #
##  #   ##   #  #  #  ### # #                 #  #     #     #
# #  ##  #   #  #  #        #                 #  #     #     #
#  #  ## #   #  #  ## ####  #  ######## #######  #######     #
##  #  # #   #  #  #     #                                   #
# # E  # #   #     #     #                                   #
##############################################################
