##############
#      #     #
#  ### ###   #
#  #S  #E    #
#  ########  #
##  #    #  ##
#   ###  ##  #
#            #
##############
