################################
#S                             #
#                              #
#                              #
#                              #
#                              #
#                              #
#                              #
#                              #
#                              #
#                             E#
################################
